 ##### 
 #   ##
##.#$ ##
# $    #
#. .#$ #
### @ ##
  # # #
  #   #
  ##### 