     #### 
######  # 
# $  $  # 
# #  .# ##
#  . #.@ #
##$# *   #
 #   #####
 #####    