############  
#..  #     ###
#..  # $  $  #
#..  #$####  #
#..     @##  #
#..  # #  $ ##
###### ##$ $ #
  # $  $ $ $ #
  #    #     #
  ############